############################### 
#    #              #         # 
#    #              #         # 
#    #              #         # 
#    #              #         # 
#    #    ######    #    #    # 
#    #    #    #         #    # 
#    #    #    #         #    # 
#    #    #    #         #    # 
#    #    #    #         #    # 
#    #    #    ###########    # 
#                   #         # 
#                   #         # 
#                   #         # 
#                   #         # 
###########    ######    ###### 
#    #                        # 
#    #                        # 
#    #                        # 
#    #                        # 
#    ######    ######         # 
#                   #         # 
#                   #         # 
#                   #         # 
#                   #         # 
#         #         ########### 
#         #                   # 
#         #                   # 
#         #                   # 
#         #                   # 
############################### 
                                